11111111111111
1E0100ECEEE001
10000111111001
1C0011P00C0001
11111111111111