1111111111111111111
10C10000000000000C1
1000011100000111001
1P0011E000000C0001
10001100000000C0001
1111111111111111111