1111111111111111111
10E1000000000001EC1
111001110011E111001
1P0011E0001CCCC1001
10001100001111C1001
1111111111111111111